RGBStrip	KEYWORD1
Std12VOutput	KEYWORD1
Switch	KEYWORD1
OptoSwitch	KEYWORD1
Insert	KEYWORD1
StdInput	KEYWORD1
LightStrip	KEYWORD2
SwitchOff	KEYWORD2
MakeFlashes	KEYWORD2
SetBrightness	KEYWORD2
RainbowColorChange	KEYWORD2
SetRainbowSpeed	KEYWORD2
SetupMultiColorFlash	KEYWORD2
MultiColorFlash	KEYWORD2
SetupTwoColorFlash	KEYWORD2
TwoColorFlash	KEYWORD2
SetupTwoColorFade	KEYWORD2
TwoColorFade	KEYWORD2
Output	KEYWORD2
OutputWithDelay	KEYWORD2
ReadSwitch	KEYWORD2
ReadSwitchDelayed	KEYWORD2
InsertOn	KEYWORD2
GetBlinkInsertState	KEYWORD2
ReadInput	KEYWORD2
